########################################
#......................................#
#......................................#
#......................................#
#...###.........................###....#
#...###.........................###....#
#...###.........................###....#
#......................................#
#......................................#
#.........###..............###.........#
#.........###..............###.........#
#.........###..............###.........#
#......................................#
#......................................#
#...............########...............#
#...............########...............#
#......................................#
#......................................#
#......................................#
#......................................#
#......................................#
#......................................#
#...............########...............#
#...............########...............#
#......................................#
#......................................#
#......................................#
#.........###..............###.........#
#.........###..............###.........#
#.........###..............###.........#
#......................................#
#......................................#
#......................................#
#...###..........................###...#
#...###..........................###...#
#...###..........................###...#
#......................................#
#......................................#
#......................................#
########################################