########################################
#......................................#
#......................................#
#.................####.................#
#...###...........####..........###....#
#...###...........####..........###....#
#...###.........................###....#
#......................................#
#......................................#
#.........###..............###.........#
#.........###......##......###.........#
#.........###......##......###.........#
#..................##..................#
#..................##..................#
#...............########...............#
#...............########...............#
#......................................#
#......................................#
#......................................#
#......................................#
#......................................#
#......................................#
#...............########...............#
#...............########...............#
#..................##..................#
#..................##..................#
#..................##..................#
#.........###......##......###.........#
#.........###..............###.........#
#.........###..............###.........#
#......................................#
#......................................#
#......................................#
#...###..........................###...#
#...###...........####...........###...#
#...###...........####...........###...#
#.................####.................#
#......................................#
#......................................#
########################################